16 16
2 2 2 2 2 2 2 2 2 2 2 2 2 2 2 2
2 2 9 2 8 9 2 2 2 2 2 2 12 2 2 2
2 2 9 6 7 9 2 2 2 2 2 2 11 2 2 2
2 2 9 5 2 9 2 2 2 2 2 2 10 2 2 2
2 2 9 4 3 9 2 2 2 2 2 2 9 2 2 2
2 2 2 2 2 2 2 2 2 2 2 2 8 2 2 2
2 2 9 9 1 9 2 2 2 2 2 2 7 2 2 2
2 2 9 2 1 9 2 2 2 2 2 5 6 2 2 2
2 2 2 2 2 2 2 2 2 2 2 4 2 2 2 2
2 2 9 2 8 9 2 2 2 2 2 3 2 2 2 2
2 2 9 6 7 9 2 2 2 2 2 2 2 2 2 2
2 2 9 5 2 9 2 2 2 2 2 1 2 2 2 2
2 2 9 4 3 9 2 2 2 2 2 2 2 2 2 2
2 2 2 2 2 2 2 2 2 2 2 2 2 2 2 2
2 2 9 9 1 9 2 2 2 2 2 2 2 2 2 2
2 2 9 2 1 9 2 2 2 2 2 2 2 2 2 2
