8 8
2 2 2 2 2 2 2 2
2 2 9 2 8 9 2 2
2 2 9 6 7 9 2 2
2 2 9 5 2 9 2 2
2 2 9 4 3 9 2 2
2 2 2 2 2 2 2 2
2 2 9 9 1 9 2 2
2 2 9 2 1 9 2 2
